Political power :: Politicka moc
Stability       :: Stabilita
War support     :: Vojnová podpora
Manpower        :: Ľudská sila

[National] focus :: [Národné] zameranie
Decision         :: Rozhodnutie
Event            :: Udalosť
News [event]     :: Noviny (novinná udalosť)
Balance of power :: Rovnováha síl

Trigger  :: Spúšťač
Effect   :: Účinok (change needed?)
Modifier :: Modifikátor

Army       :: Armáda
Army group :: Armádna skupina
Theater    :: Dejisko
Navy       :: Námorníctvo
Fleet      :: Flotila
Air force  :: Vzdušné sily
Air wing   :: Vzdušné krídlo

Strategic region :: Strategický región
State            :: Územie
Province         :: Provincia
Core [state]     :: Základové územie (základ)
Claim            :: Nárok
Claimed state    :: Nárokované územie
Colony           :: Kolónia
Owner            :: Majiteľ
Controller       :: Ovládač

Combat width  :: Bojová šírka
Training time :: Čas na výcvik

# AUTONÓMIA #
Subject [country] :: Podriadená krajina (podriadenec)
Puppet [country]  :: Bábková krajina (bábka)

# OKUPACIA #
Garrison   :: Garnizón
Resistance :: Odpor
Compliance :: Podriadenosť